#######################################
# Syntax Coloring Map For Q2HX711
#######################################

#######################################
# Datatypes (KEYWORD1)
#######################################

Q2Balance	KEYWORD1
BalanceCalibrationStruct	KEYWORD1

#######################################
# Methods and Functions (KEYWORD2)
#######################################

TARELIMIT	KEYWORD2
JUMPLIMIT	KEYWORD2
SAMPLE_COUNT	KEYWORD2
taring	KEYWORD2
tared	KEYWORD2
settling	KEYWORD2
adjustedValue	KEYWORD2
adjustedRawValue	KEYWORD2
smoothValue	KEYWORD2
rawValue	KEYWORD2
jitter	KEYWORD2
calibrateZero	KEYWORD2
calibrate	KEYWORD2
calibrating	KEYWORD2
measure	KEYWORD2
tare	KEYWORD2
settle	KEYWORD2
setCalibration	KEYWORD2
tick	KEYWORD2

#######################################
# Constants (LITERAL1)
#######################################

Q2BALANCE_MARKER_COUNT	LITERAL1
Q2BALANCE_UNIT_GRAM	LITERAL1
Q2BALANCE_UNIT_POUND	LITERAL1
Q2BALANCE_UNIT_OUNCE	LITERAL1
Q2BALANCE_UNIT_GRAIN	LITERAL1
Q2BALANCE_UNIT_TROY	LITERAL1
Q2BALANCE_UNIT_PWT	LITERAL1
Q2BALANCE_UNIT_CARAT	LITERAL1
Q2BALANCE_UNIT_NEWTON	LITERAL1
